R 1900 1080
NO ./textures/greystone.xpm
SO ./textures/redbrick.xpm
EA ./textures/purplestone.xpm
WE ./textures/wood.xpm
S ./textures/barrel.xpm
F 122,122,255
C 255,200,160

 111111111
1000N000001
10002000001
1111111111
1
21111111111
10000000001
10000000001
11111111111








