R 1920 1080
NO ./textures/greystone.xpm
SO ./textures/redbrick.xpm
EA ./textures/purplestone.xpm
WE ./textures/wood.xpm
S ./textures/barrel.xpm
F 122,122,122
C 255,200,160

 111111111
10000000001
10002000001
1000N000001
11111111111
 
11101111111
10000000001
 111111111





