R 1920 1080
NO ./textures/wood.xpm
SO ./textures/wood.xpm
EA ./textures/wood.xpm
WE ./textures/wood.xpm
S ./textures/barrel.xpm
C 100, 240, 222
F 234,33,99

11111111111111111
10000000000000001111111
100000000200000010000001
100000N0000000000001
100000000000000010000001
10000000000000001111111
11111111111111111
