C 255,222,162
R 1080 720
NO /tester/wolftex/textures/xpm/greystone.xpm
SO ./tester/wolftex/textures/xpm/redbrick.xpm
EA ./tester/wolftex/textures/xpm/wood.xpm
WE ./tester/wolftex/textures/xpm/pillar.xpm
S ./tester/wolftex/textures/xpm/barrel.xpm
F 122,122,122

111111
1N0001
102001
111111
