R 1181 721
NO ./tester/wolftex/textures/xpm/greystone.xpm
SO ./tester/wolftex/textures/xpm/redbrick.xpm
EA ./tester/wolftex/textures/xpm/wood.xpm
WE ./tester/wolftex/textures/xpm/pillar.xpm
S ./tester/wolftex/textures/xpm/barrel.xpm
C 255,222,162
F 122,122,122

11111111111111111
10000000N00000001
10000000000000001
10000000000000001
10000000000000001
10000000000000001
10202020002020201
10000000000000001
10002000200200001
10000000000000001
10200000200002001
10000000000000001
11111111111111111

11111111111111111
10000000000000001
10200000200000201
10000000000000001
10002000200020001
10000000000000001
10202020002020201
10000000000000001
10002000200200001
10000000000000001
10200000200002001
10000000000000001
11111111111111111

11111111111111111
10000000000000001111111
10000000020000000000001
100000N00000000000001
10000000000000000000001
10000000000000001111111
11111111111111111
