R 1920 1080
NO ./tester/wolftex/textures/xpm/wood.xpm
SO ./tester/wolftex/textures/xpm/wood.xpm
EA ./tester/wolftex/textures/xpm/wood.xpm
WE ./tester/wolftex/textures/xpm/wood.xpm
S ./tester/wolftex/textures/xpm/barrel.xpm
C 100, 240, 222
F 234,33,99

11111111111111111
10000000000000001111111
100000000200000010000001
100000N00000000010000001
100000000000000010000001
10000000000000001111111
11111111111111111
