R 1920 1080
NO ./textures/greystone.xpm
SO ./textures/redbrick.xpm
EA ./textures/wood.xpm
WE ./textures/pillar.xpm
S ./textures/barrel.xpm
C 25,222,162
F 122,22,122

11111111
10000001
10N00111
10000101
11111111
