R 1080 420
NO ./wolftex/textures/xpm/greystone.xpm
SO ./wolftex/textures/xpm/redbrick.xpm
EA ./wolftex/textures/xpm/wood.xpm
WE ./wolftex/textures/xpm/wood.xpm
S ./wolftex/textures/xpm/barrel.xpm
C 25,      								       255                                ,254
F 100,200,160

  111111
  100101
11120001
1100N001
11111111
