R 640 480
NO ./wolftex/textures/xpm/greystone.xpm
SO ./wolftex/textures/xpm/redbrick.xpm
EA ./wolftex/textures/xpm/wood.xpm
WE ./wolftex/textures/xpm/wood.xpm
S ./wolftex/textures/xpm/barrel.xpm
C 25,255,254
F 100,220,160

11111111
10000101
11120001
1100N001
11111111
